31
Berghe Sergiu - Flaviu
Berinde Larisa - Danesa
Bila Sebastian - David
Bohuº David - Jonatan
Buciuman Raul
Ciuculescu Beniamin - Costel
Ciucur Adrian
Cuc Patricia - Damaris
Feier Flaviu - Daniel
Gangoº George
Gheþi Sefora
Hora Emil - Timotei
Hoºman Patricia
Hriþcu Andreea
Ille Luciana
Indrieº Alexandru - Nicolae
Ivan-Leþ Doru - Sebastian
Mag Marin - Adrian
Moca David
Morar Antoniu - Daniel
Noane Damaris - Adriana
Pantiº Marcus - ªerban
Sãutiuþ Titus - Andrei
Secarã Alex - Raul
Suiugan Adalia - Valentina
Terebenþ Patricia - Rebeca
Tiutiu Natan - Gabriel
Þenþ Dalia - Loredana
Þigan Andrei - Florin
Van Velden Emil - Daniel