35
Ardelean Alexandra
Bala Andrei - Samuel
Berghe Cristina - Andrada
Bidilean Simona - Gabriela
Boldiº Darius - Beniamin
Butuc-Mayer Filip
Codrean Andrea - Florina
Cuciula Ionatan - Corneliu
Duþã David - Andreas
Fazecaº Ruth - Rebeca
Gherle Timotei - Titus
Gheþe Rebeca - Estera
Ghiurãu David
Guþ Larisa - Camelia
Hosman Rafaela
Moca Titus - Viorel
Modoc Daniel - ªtefan
Molcuþ Timotei
Oprea Paula - Cristina
Orbai Iulian - Andrei
Pal George - Iacov
Pantiº Beniamin
Pãtcaº Adela - Alexandra
Pop Andreea - Mãrioara
Racolþa Andreea - Ioana
Roºcãu Denisa - Rebeca
Sava Remus - Cosmin
Silaghi Andrei - Titus
Simota Matei - Eugen
Tiutin Cristina - Maria
Trifan Marc - Titus
Vinter Damaris
Zah Daniel - Timotei
Zmole Patricia