32
Bala Gabriel - Aurel
Barbur Dragoº - Constantin
Bodog Matei - Elias
Bohuº Emanuel - Ovidiu
Burcã Ana - Iulia
Cãrcãleanu Ana - Maria
Cheþ Gabriel - Felipe
Chifor David - Mihai
Cioarã Nicolas - Timotei
Cosma Sharis - Victoria
Duma David - Emanuel
Dumuþa David
Erdeli Evelin - Hanna
Furic Amalia - Eliza
Gal-Chiº Naomi - Evelyn
Hnatiuc Alexandru
Iova Zara - Xenia - Carol
Lal Georgiana - Alexandra
Lazurcã Iosua - Corneliu
Liberþ David - Andrei
Mariº Yannis - Luca
Micula Alexandru - David
Mureºan Alexandra - Maria
Naroº Emanuel
Pop Isabelle - Sophie
Teodorescu Andrei - Daniel
Trifu Patricia - Antonia
Vaida Eliza - Nicoleta
Vidican Samuel - David
Vidican Yannis - Aser
Zifceac Patrick - Lucas