34
Brîndaº Iulia - Cãlina
Caba ªtefan - Nathan
Chiº Noris - Fineas
Ciarnãu Mara - Teodora
Cionca Elisa
Coita Rianna - Daniela
Corb Sara - Maria
Corb Titus - Horaþiu
Corba Darius - Ciprian
Crãciun Petru - Samuel
Derecichei Lucas - Aron
Gavriº George - Mihai
Gliþia Bianca - Alexandra
Goman Diana - Andreea
Hriþcu ªerban
Ilisie Ianis - Raul
Ilisie Andrei
Luncan Naomi - Emanuela
Marc Alexia - ªtefania
Marc Rebeca
Mocan Eduard - Cãtãlin
Moraru Iulia - Maria
Muþ Linette - Victoria
Omuþ Emanuela - Ioana
Opriº Casia - Leora
Pop Ambra - Cãlina
Potroviþã Briana
Potroviþã Sara
Sarca Dan - Alexandru
Turcuº Georgiana - Carina
Ungur Teodora - Mãdãlina
Ungur Andreea - Monica
Voinkov Bogdan - Mihail