31
Abrudan Andrei - Naum
Boc Felix - Rãzvan
Bottyán Rebeca - Anamaria
Bucur Lorena
Ciurdar Carla - Cipriana
Durne Casian - Viorel
Fechete Sorin
Gui Sara - Alisia
Iºtoc-Zembrea Antonio - Roberto
Kiss Rebeca
Lascu Cristian - Marc
Leucuþa Flaviu - ªerban
Lingurar Bogdan - Eugen
Majoros-Garofeanu Balthasar - Gabriel
Moca Iulia
Muntean ªtefan - Sebastian
Oprea Tania - Maria
Palladi Maria - Anastasia
Piscoi David - Timotei
Platona Beatrice
Pop Lucas - Daniel
Pop Lois
Pop Rebeca
Popoviciu Sara
Posa David - Sebastian
Rus David
ªuºman Luca - Ianis
Teodorescu Larisa - Daria
Teºedan Marcus - Gabriel
Tripa Lucas - Pompiliu