32
Anton Lucian - Antonio
Ardelean Dominique
Ardelean Rebeca - Miriam
Bîrle Tudor - Bogdan
Bodog Gianina - Lorena
Cadar Sofia
Cheon Siyoon
Cojan Loriana - Maria
Domocoº Luiza - Maria
Fazecaº Joshua - Manuell
Fãgãrãºanu Alice
Gabor Denis - Adrian
Galea Darius
Galiº Alexandru - George
Iambor Laurenþiu - Fabian
Iegar Sara - Daniela
Kõteles-Popa Moise - Tiberiu
Kovacs Mark - Paul
Micula Sergiu - ªtefan
Mihele Daymond - Elurian
Opreanu Naomi
Opriº Matia - Elisei
Pãdure David
Petruº Sara - Andreea
Pop Patricia - Carla
Pop Andrei - Darius
Popoviciu Paul - Gabriel
Roman Edvin - Lucas
Rus Aseneth - Naomi
Serecuþ Rebeca
Tãºãdan Luca