34
Antal Arcadie - Valentin
Béldi Stefánia - Marta
Berian Sofia
Blaga Medeea
Cosma Amelia - Carla
Costiniuc Daria
Cuciula Anamaria - Ioana
Damºe Denis - Andrei
Drugaº Rebeca - Bianca
Drugaº Daria - Hadasa
Ficuþ Antonia - Alexia
Fildan David - Cristian
Gros David - Ovidiu
Haniº Rareº - Antoniu
Heredea Marc - Marian
Lata Mihai - Sebastian
Lencar David - Leon
Luncan Timotei - Emanuel
Mangra Dani - Alexandru
Marc Alexandra
Marton Andrei - David
Moga Alexia - Cristina
Mounir-Awad-Guirgis Julian - Timotei
Nan Andreea - Denisa
Popoviciu Ianis - Noah
Popoviciu Debora - Roxana
Somogyi Brian - David
Soriþãu Karis - Eliana
ªchiopu Flaviu - Denis
Teºedan Naomi
Þundrea Natanael
Vaº Marcus - David
Vereº Beniamin - Cãlin