31
Bara Emilia - Antonia
Barbur Tudor - Andrei
Bejinariu Andreea - Cristina
Bohuº Timotei - Josua
Boldiº Denis - Ionuþ
Bungãu Oana
Cadar Andrei
Cãrcãleanu David
Curtui Natalia - Naomi
Durne Daria - Alina
Gherle Darius - Cristian
Ghiurãu Lucas - Cristian
Haivas Adrian - George
Ivan-Leþ Giulia - Rafaela
Lal Eduard - Ioan
Matei Sever
Mocanu Nicoleta - Ramona
Muntean Alexandru - George
Negruþ Daria - Maria
Pantiº Thommy - Cristian
Papp Alexandra
Pop David - Laurenþiu
Pop Roberta - Emanuela
Popa David
Popa Madeleine
Pruncuþ Maria - Rebeca
Sabãu Timotei
ªandor Cristian
ªiºca Cristian
Traicu Alexandra - Rebeca