32
Berian Clara
Blaga Sophia
Bondar Iosua - Florentin
Corduneanu Casandra - Maria
Drenyovszky Sara - Gabriella
Firus Luca
Ganea Mãdãlin - Florin
Gheorghe? Rãzvan - Alin
Golovashkin Savva
Gordan Titus - Emanuel
Horaniþ Miriam - Tania
Ibãnescu Daniel - Ionuþ
Jurcuþiu Gabriela - Marcela
Kolster Priscillia - Grace
Kovacs Erik - Beniamin
Leuca Ioan - Bogdan
Maxim Naomi - Marinela
Pop Bianca - Debora
Popovici Teofil - Cristian
Puºcaº Antonia - Naomi
Roºca Pavel - Daniel
Roºu Filip
Ruge Aida - Ioana - Maria
Sãlãjan Carla - Maria
Sãvianu Nathasa - Alessia
Sime Patricia - Olivia
Sîrb Maria - Felicia
Stepan Maria - Alexandra
ªipa Magdiel - Teofil
Turcuº Cãtãlina - Maria
Þic Narcisa - Naomi